00010010000011000000000000000000
00000111000100000101000001100100
00010001000011000100000000001111
00000111000011000011000000000001
00000111000101001010000000000001
00000110000110000011000000000100
00000111001100001100000000000001
00010001000110001100000000000110
00000111000110000110000000000100
00010001000110001100000000001000
00010011000110000000000000000001
00010011000011000000000000000000
00010011000100000000000000000010
00000110000100000100000000000110
00010001000100000011000000000000
00010011000011000000000000000001
